1111111111111
10W1P0010CW11
1C010100000C1
100C011111011
100011E000001
1111111111111