1111111
1CP10E1
100W0W1
1111111
