11111111111111111111111111111111111
10000C0000000000000000W00000C000001
10000000000000000000000000000000001
10011011011110111101110100001111001
10010101010010100100100100001000001
1C0101010100101110W0100100C011110P1
10010W01010010100100100100001C00001
10010001011110111101110111101111001
10000000000000000000000000000000001
10000C0000000000000E000000000000001
10000000000000000000000000000000001
11111111111111111111111111111111111
