1111111111111111111111111
1P010001000000000000C1111
100C00000111000001000C111
1101110000011000110000C11
1000100W000000001100W00C1
1000100000011000111000001
1000100001000000011100001
10000C001100C00C001110001
1110000110000000W01111001
10011101000C00100000000C1
10000000000000100C0001111
10C00111111000100000111C1
100000011100000000111C001
1001111110000111000000001
1000W00C00000000000W00001
10011100011100110001CC001
10000001000001100001000E1
1111111111111111111111111
